ABIES	EY B IY Z
ABIOGENESIS	AH B AY OW JH EH N AH S AH S
ABOMINATE	AH B AO M AH N EY T
ABSENTLY	AE B S AH N T L IY
ACCADEMIA	AE K AH D IY M IY AH
ACCESSIONS	AE K S EH SH AH N Z
ACCLIVITIES	AH K L IH V IH T IY Z
ACCURSED	AE K Y ER S T
ACOUNT	AH K UW N T
ACQUIREMENTS	AH K W AY R M AH N T S
ACQUISITORIAL	AE K W AH Z AH T AO R IY AH L
ACTUATED	AE K CH UW EY T IH D
ADIEUX	AH D IY OW
ADMIRABLENESS	AE D M ER AH B AH L N AH S
ADVENTURETH	AE D V EH N CH ER AH TH
ADZES	AE D Z AH Z
AFFLATUS	AH F L EY T AH S
AGGREGATION	AH G R AH G EY SH AH N
AIRPUMPS	EH R P AH M P S
ALCHEMISTS	AA L K EH M AH S T S
ALIENATIONS	EY L IY AH N EY SH AH N Z
ALLOWETH	AE L AH W EH TH
AMPERE	AE M P ER
AMPERE'S	AE M P ER Z
ANAGAZANDERS	AH N AE G AH Z AE N D ER Z
ANALYSING	AE N AH L IH Z IH NG
ANANTARIVO	AE N AH N T EH R IY V OW
ANCIENTLY	EY N SH AH N T L IY
ANON	AE N AH N
ANOTHERS	AH N AH DH ER Z
ANTECHAMBERS	AE N T EH K AH M B ER Z
ANTINOMIES	AE N T IH N AH M IY Z
APOSTEMES	AH P AA S T EH M Z
APPERTAIN	AH P ER T EY N
APPREHENSIBLE	AH P R IH HH EH N S AH B AH L
ARAGO	AA R AA G OW
ARDOUR	AA R D AO R
ARISETH	AA R IY S EH TH
ARISTOCRATICALS	ER IH S T AH K R AE T IH K AH L Z
ARMENONVILLE	AA R M EH N AH N V IH L
ARTILLERIST	AA R T IH L ER IH S T
ASCALON	AE S K EY L AH N
ASCERTAINMENT	AE S ER T EY N M AH N T
ASCRIBING	AH S K R AY B IH NG
ASHLEIGH	AE SH L AH
ASHLEIGH'S	AE SH L IY Z
ASHUELOT	AE SH UW L AH T
ASPHALTIC	AE S F AO L T IH K
ASSENTED	AH S EH N T IH D
ASSINIBOIN	AH S IH N IY B OY N
ASTERN	AE S T ER N
ASTRONOMER'S	AE S T R AA N AH M ER Z
ATHABASCA	AH TH AA B AA S K AH
ATHAPESKOW	AE TH AH P EH S K AW
ATHIRST	AH TH ER S T
ATING	EY T IH NG
ATOMICITY	AH T AA M IH S IH T IY
ATOMISM	AE T AH M IH Z AH M
ATONED	AH T OW N D
AVIDITY	EY V IH D IH T IY
AVOGADRO	AH V OW G AH D R OW
BACONIAN	B AH K OW N IY AH N
BACONIANS	B AH K OW N IY AH N Z
BAFFIN'S	B AE F IH N Z
BALUSTRADED	B AH L AH S T R EY D IH D
BANDANNA	B AE N D AE N AH
BANEFUL	B EY N F AH L
BARDS	B AA R D Z
BAREFOOTED	B EH R F UH T IH D
BARILLON	B EH R IH L AH N
BARQUES	B AA R K S
BATTUES	B AA T UW Z
BAVIAAN	B EY V IY AA N
BAVIAAN'S	B EY V IY AA N Z
BEARSKINS	B ER S K IH N Z
BECOMINGLY	B IH K AH M IH NG L IY
BECOMINGNESS	B IH K AH M IH NG N IH S
BEDMAKING	B EH D M EY K IH NG
BEDSTEAD	B EH D S T EH D
BEHELD	B IH HH EH L D
BENWICK	B EH N W IH K
BETAKEN	B IY T EY K AH N
BEVELED	B EH V AH L D
BEWITCHING	B IH W IH CH IH NG
BIJOU	B IH JH UW
BINNACLE	B IH N IH K AH L
BIOT	B AY AH T
BIRCHES	B ER CH IH Z
BISONS	B IH S AH N Z
BITINGLY	B AY T IH NG L IY
BLACKISH	B L AE K IH SH
BLACKSMITH'S	B L AE K S M IH TH S
BLATCHY	B L AE CH IY
BLUBBERING	B L AH B ER IH NG
BOATSWAIN'S	B OW T S W EY N Z
BOBBED	B AA B D
BOLING'S	B OW L IH NG Z
BOLTON'S	B OW L T AH N Z
BONDITCH	B AA N D IH CH
BORROWETH	B AA R OW IH TH
BOSCOVICH	B AA S K AH V IH CH
BOTANIQUE	B AH T AE N IH K
BOWSPRIT	B AW S P R IH T
BRACTED	B R AE K T IH D
BRAHMA	B R AA M AH
BRAHMAPUTRA	B R AA M AH P UW T R AH
BRANCHLESS	B R AE N CH L AH S
BRAYING	B R EY IH NG
BREECHES	B R IY CH IH Z
BRIAREUS	B R AY R UW S
BRIARPATCH	B R AY R P AE CH
BRIGS	B R IH G Z
BRILLIANCY	B R IH L Y AH N S IY
BRIMFUL	B R IH M F AH L
BRODIE'S	B R OW T IY Z
BRUMMEL'S	B R AH M AH L Z
BUFFALOES	B AH F AH L OW Z
BUFFON	B AH F AH N
BULGY	B AH L JH IY
BULWARKS	B UH L W ER K S
BUMPO	B AH M P OW
BUNELL	B AH N AH L
BURS	B ER Z
BUSYBODY	B Y UW Z IY B AH D IY
BUTTED	B AH T IH D
BUTTON'S	B AH T AH N Z
BUYETH	B AY EH TH
CALATE	K AE L AH T
CALCAREOUS	K AE L K AH R IY AH S
CALIBRE	K AE L AH B R AH
CALICES	K AE L AH S AH Z
CALLETH	K AE L IH TH
CAMEELIOUS	K AE M IY L Y AH S
CAPARISONS	K AH P AE R IH S AH N Z
CAPITALLY	K AE P AH T AH L IY
CAPTIOUS	K AE P SH AH S
CARICES	K AA R IH S IH Z
CARPENTARIA	K AA R P AH N T EH R IY AH
CARPENTERING	K AA R P EH N T ER IH NG
CARRYL	K EH R AH L
CARTESIANS	K AA R T IY ZH AH N Z
CASTILLEIA	K AA S T IY EY AH
CATASTROPHISM	K AH T AE S T R AH F IH Z AH M
CATESBYS	K AH T EH S B IY Z
CAUSA	K AO Z AH
CAUSELESS	K AA Z L AH S
CEANOTHUS	SH AH N AH DH AH S
CELLARAGE	S EH L ER EY JH
CENTRED	S EH N T ER D
CESSION	S EH SH AH N
CHAFFING	CH AE F IH NG
CHALDEES	HH AA L D IY Z
CHAMAEBATIA	CH EY M EY B AA T IY AH
CHAMOEBATIA	SH AH M IY B AH T IY AH
CHAMOIS	CH AE M W AA
CHARACTERISES	K EH R IH K T ER AY Z IH Z
CHARMEUSE	CH AA R M IY UW Z
CHARR	CH AA R
CHASTENING	CH EY S AH N IH NG
CHATTERED	CH AE T ER D
CHECKSUM	CH EH K S AH M
CHEERFULNESS	CH IH R F AH L N AH S
CHEERILY	CH IH R AH L IY
CHEERLESS	CH IH R L AH S
CHEOPS	CH IY AO P S
CHIDIOCK	CH IH D IY AH K
CHIFFONS	SH IH F AA N Z
CHINE	CH AY N
CHINTZ	CH IH N T S
CHIPPEWAY	CH IH P W EY
CHIRRUPED	CH ER AH P T
CHRISTIANIA	K R IH S T IY AA N IY AH
CHRONOMETER	K R AH N AA M AH T ER
CIRCLETS	S ER K AH L EY Z
CIRCUMAMBULATE	S ER K AH M AE M B Y AH L EY T
CIVILISATION	S IH V AH L IH Z EY SH AH N
CIVILISED	S IH V AH L IH Z D
CIVILITIES	S AH V IH L AH T IY Z
CIVITAS	S IH V AH T AH S
CLANGED	K L AE NG D
CLASPING	K L AE S P IH NG
CLASSIFICATORY	K L AE S AH F AH K EY T ER IY
CLAY'S	K L EY Z
CLEARINGS	K L IH R IH NG Z
CLEARNESS	K L ER N AH S
CLEVEREST	K L EH V R AH S T
CLIMATOLOGY	K L AY M AH T AA L AH JH IY
CLIPPA	K L IH P AH
CLOAKS	K L OW K S
CLONTARF	K L OW N T AA R F
CLOOP	K L UW P
CLOVE	K L OW V IY
COARSELY	K AO R S L IY
COBB'S	K AA B Z
CODLING	K AA D L IH NG
COENTIES	K OW AH N IY Z
COGNISANCE	K AA G N IY Z AH N S
COLLIGATE	K AA L AH G EY T
COLONNADES	K AH L OW N EY D Z
COLOUR	K AH L ER
COLOURLESS	K AH L ER L AH S
COLOURS	K AH L ER Z
COMESTIBLE	K OW M S T AH B AH L
COMESTIBLES	K OW M S T AH B AH L Z
COMMITTETH	K AH M IH T IH TH
COMMONALTY	K AA M AH N AH L T IY
COMMONEST	K AA M AH N EH S T
COMPANION'S	K AH M P AE N Y AH N Z
COMPASSES	K AH M P AE S IH Z
COMPOSEDLY	K AH M P OW Z AH D L IY
COMPOSITING	K AA M P AA Z AH T IH NG
COMTE	K AA M T
CONCEITS	K AH N S IY T S
CONCERNMENT	K AH N S ER N M AH N T
CONCOLOR	K AA N K AH L ER
CONCORDANCE	K AA N K AO R D AH N S
CONDUCE	K AA N D UW S
CONFLUX	K AH N F L AH K S
CONFORMATION	K AH N F AO R M EY SH AH N
CONNEXION	K AH N EH K SH AH N
CONNEXIONS	K AH N EH K SH AH N Z
CONSIDERETH	K AH N S IH D ER IH TH
CONTIGUITY	K AH N T IH G Y UW AH T IY
CONTORTA	K AH N T AO R T AH
CONTRADICTETH	K AH N T R AH D IH K T IH TH
CONTRADISTINCTION	K AH N T R AH D IH S T IH NG K SH AH N
CONTROVERTED	K AH N T R OW V ER T IH D
CONVENTIONALITIES	K AH N V EH N CH AH N AE L IH T IY Z
COPESTONE	K OW P S T OW N
COPPERMINE	K AA P ER M AH N
COPSES	K AA P S IH Z
COREGONUS	K AO R G OW N AH S
CORLEARS	K AO R L IY R Z
CORNED	K AO R N D
CORPULENT	K AO R P UW L AH N T
CORPUSCLES	K AO R P AH S AH L Z
CORPUSCULAR	K AO R P AH S K Y AH L ER
COSINE	K AH S IY N IY
COSMICAL	K AO Z M IH K AH L
COSMOGONY	K AO Z M OW G OW N IY
COTTONTAIL	K AA T AH N T EY L
COUNCILLORS	K AW N S IH L ER Z
COWES	K AW Z
CPU	S IY P IY Y UW
CRACKLY	K R AE K L IY
CRADLED	K R EY D AH L D
CRAVENTY	K R EY V AH N T IY
CRAVENTY'S	K R EY V AH N IY Z
CREATOR'S	K R IY EY T ER Z
CREATURE'S	K R IY CH ER Z
CREEPED	K R IY P T
CRICHTONS	K R IH CH T AH N Z
CROCODILE'S	K R AA K AH D AY L Z
CROFT'S	K R AO F T S
CROONED	K R UW N D
CROQUETTES	K R OW K EH T S
CROSSLY	K R AA S L IY
CRUCIBLES	K R UW S AH B AH L Z
CRYPTOGAMS	K R IH P T OW G AH M Z
CUI	K W IY
CUMBROUS	K AH M B R AH S
CUNNINGLY	K AH N IH NG L IY
CUPPED	K AH P T
CURLEW	K ER L UW
CURRANTS	K AH R AH N T S
CURTIOSITIES	K ER T IY AA S AH T IY Z
CURTIOSITY	K ER T IY AA S AH T IY
CURTSEY	K ER T S IY
CUTUM	K Y UW T AH M
CUVIER	K UW V IY ER
CYNISCA	S IH N IH S K AH
CYPRIPEDIUM	S IH P R IY P IY D IY AH M
DABCHICKS	D AE B CH IH K S
DAGUERREOTYPES	D AA G ER R IY AH T AY P S
DAHLIAS	D AE L Y AH Z
DAINTIER	D EY N T IY ER
DALTONIAN	D AO L T OW N IY AH N
DARWIN'S	D AA R W IH N Z
DAUGHTRY'S	D AO T R IY Z
DAVIES'S	D EY V IY Z IH Z
DAVY'S	D EY V IY Z
DAYLIGHT'S	D EY L AY T S
DE'ULLOA	D IY UW L OW AH
DEAUVILLE	D OW V IH L
DEBTER	D EH T ER
DECANDOLLE	D IY K AE N D OW L
DECOCTION	D EH K AA K SH AH N
DECOMPOSITIONS	D IY K AH M P OW Z IH SH AH N Z
DECURRENS	D IY K ER AH N Z
DEDUCIBLE	D IH D UW S AH B AH L
DEI	D EY
DELLS	D EH L Z
DEMOCRATICALS	D EH M AH K R AE T IH K AH L Z
DEMOCRITIC	D EH M AH K R IH T IH K
DEMOCRITUS	D IH M AA K R AH T AH S
DENNIN'S	D EH N IH N Z
DENUDATION	D IH N UW D EY SH AH N
DEODAR	D IY OW D AA R
DEPENDETH	D IH P EH N D IH TH
DESIRABLENESS	D IH Z AY R AH B AH L N AH S
DESISTED	D EH Z IH S T IH D
DESOLATING	D EH S AH L EY T IH NG
DESPATCHED	D EH S P AE CH T
DESPONDENTLY	D IH S P AA N D AH N T L IY
DETACHMENTS	D IH T AE CH M AH N T S
DEXTEROUS	D EH K S T ER AH S
DEXTEROUSLY	D EH K S T ER AH S L IY
DIALECTICS	D AY AH L EH K T IH K S
DIFFRACTED	D IH F R AE K T IH D
DIFFUSIBILITY	D IH F Y UW Z AH B IH L AH T IY
DILUVIAL	D IH L UW V IY AH L
DISAGREEABLENESS	D IH S AH G R IY AH B AH L N AH S
DISAPPROBATION	D IH S AH P R OW B EY SH AH N
DISCHARGETH	D IH S CH AA R JH IH TH
DISCOMFITED	D IH S K AH M F IH T IH D
DISCONTINUOUS	D IH S K AH N T IH N Y UW AH S
DISCORDANCE	D IH S K AO R D AH N S
DISCOURS	D IH S K ER Z
DISCOVERER	D IH S K AH V ER ER
DISCOVERERS	D IH S K AH V ER ER Z
DISCRIMINATINGLY	D IH S K R IH M AH N EY T IH NG L IY
DISJUNCTION	D IH S JH AH NG K SH AH N
DISMISSION	D IH S M IH SH AH N
DISORGANISATION	D IH S AO R G AH N IH Z EY SH AH N
DISPORTED	D IH S P AO R T IH D
DISPORTING	D IH S P AO R T IH NG
DISPROPORTION	D IH S P R AH P AO R SH AH N
DISSOCIATED	D IH S OW SH IY EY T IH D
DISSOCIATIVE	D IH S OW SH IY EY T IH V
DIVERSITIES	D AY V ER S AH T IY Z
DIVINED	D IH V AY N D
DIVINES	D IH V AY N Z
DIVISIBILITY	D IH V IH Z AH B IH L AH T IY
DJINN	JH IH N
DJINNS	JH IH N Z
DOANE'S	D OW N Z
DOLITTLE	D OW L IH T AH L
DOMO	D OW M OW
DONT	D AA N T
DOTINGS	D OW T IH NG Z
DOUGLASII	D AH G L AH S IY IY
DOULOUREUSE	D OW L AO R UW S
DRAPIEZ	D R AE P AY AH Z
DRAUGHTSMAN	D R AE F T S M AH N
DREAMIEST	D R IY M IY IH S T
DREAMILY	D R IY M AH L IY
DRETFUL	D R EH T F AH L
DROWSING	D R AW Z IH NG
DULCIBELLA	D AH L S IH B EH L AH
DUNAMIS	D UW N AA M IY Z
DYNAMICAL	D AY N AE M IH K AH L
DYSTELEOLOGIES	D IH S T IY L IY AH L OW JH IY Z
EARNIN'	ER N IH N
ECLAT	IY K L AE T
ECONOMISE	IY K AA N AH M AY Z
ECSTACIES	EH K S T EY S IY Z
EFFACED	IH F EY S T
EIDER	AY D ER
EILEEN'S	AY L IY N Z
ELAH	IY L AH
ELEGANTE	EH L AH G AH N T IY
ELIAB	IY L AY AH B
ELLIOT'S	EH L IY AH T S
ELLIPSES	EH L IH P S IH Z
ELUCIDATION	IH L UW S AH D EY SH AH N
EMANISTIC	IH M AE N AH S T IH K
EMBRACINGLY	EH M B R EY S IH NG L IY
ENCEINTE	IH N S IY IH N T
ENCODES	EH N K OW D Z
ENDEAVOURED	IH N D EH V AW ER D
ENDURINGLY	IH N D UH R IH NG L IY
ENERGEIA	EH N ER JH EY AH
ENQUIRED	EH N K W AY ER D
ENQUIRIES	EH N K W AY ER IY Z
ENQUIRING	EH N K W AY ER IH NG
EPHESIANS	IH F IY ZH AH N Z
EPHESUS	IH F IY Z AH S
EPICYCLES	EH P AH S AY K AH L Z
EQUINOCTIAL	EH K W AH N AA K T Y AH L
EQUINOXES	EH K W AH N AA K S IH Z
EQUIPAGE	IH K W IH P IH JH
EQUIPAGES	IH K W IH P IH JH IH Z
ERMINES	ER M AH N Z
ESPIES	EH S P IY Z
ESQUIMAUX	EH S K IH M OW
ESSAYED	EH S EY D
ESSENCES	EH S AH N S IH Z
EULOGISE	Y UW L AH JH AH S
EULOGISTS	Y UW L AH JH IH S T S
EUROCLYDON	Y UW R OW K L IH D AH N
EVERLASTINGLY	EH V ER L AE S T IH NG L IY
EVREMOND	EH V R AH M AH N D
EXACTNESS	IH G Z AE K T N AH S
EXCITEMENTS	IH K S AY T M AH N T S
EXPONENTIALS	IH K S P OW N EH N CH AH L Z
EXPORTATION	IH K S P AO R T EY SH AH N
EXPRESSIBLE	IH K S P R EH S AH B AH L
EXTREMEST	EH K S T R IY M EH S T
EXULTATION	IH G Z AH L T EY SH AH N
EZZ	EH Z
FA	F AH
FACTOR'S	F AE K T ER Z
FALLETH	F AE L IH TH
FAMILIARISED	F AH M IH L Y ER AY Z D
FANCYING	F AE N S IY IH NG
FARCES	F AA R S IH Z
FASHIONITIS	F AE SH AH N AY T IH S
FASTIDIOUSNESS	F AE S T IH D IY AH S N AH S
FATHOMED	F AE DH AH M EH D
FAULTLESS	F AO L T L AH S
FAUNAE	F AO N EY
FAVOUR	F EY V AW ER
FAVOURABLE	F EY V ER AH B AH L
FAVOURABLY	F EY V ER AH B L IY
FAVOURED	F EY V AW ER D
FAVOURITE	F EY V UH R AY T
FEARLESSLY	F ER L AH S L IY
FEARLESSNESS	F ER L AH S N AH S
FEEBLENESS	F IY B AH L N AH S
FERNY	F ER N IY
FERTILISATION	F ER T AH L IH Z EY SH AH N
FIDGETS	F IH JH AH T S
FIDGIT	F IH JH IH T
FIDGIT'S	F IH JH IH T S
FIDGITS	F IH JH IH T S
FINICAL	F IH N IH K AH L
FIORDS	F IY AO R D Z
FISHINGS	F IH SH IH NG Z
FIXITY	F IH K S IH T IY
FLAILSOME	F L EY L S AH M
FLENSBURG	F L EH N Z B ER G
FLOATSAM	F L OW T S AH M
FLOODMARKS	F L AH D M AA R K S
FLORAE	F L AO R EY
FLOUNCINGS	F L AW N S IH NG Z
FLOURISHINGS	F L ER IH SH IH NG Z
FLUTING	F L UW T IH NG
FOGEY	F OW G IY
FONTAINE'S	F AA N T EY N Z
FOREBORE	F AO R B ER
FORECASTLE	F AO R K AE S AH L
FOREPAW	F AO R P AO
FOREPAWS	F AO R P AO Z
FORGETFULNESS	F ER G EH T F AH L N AH S
FORMLESS	F AO R M L AH S
FORRARD	F AO R ER D
FOUNTS	F AW N T S
FOURTY	F AO R T IY
FOWLS	F AW L Z
FRAUNHOFER	F R AO N HH AH F ER
FREEWILL	F R IY W IH L
FRESNEL	F R EH S N AH L
FRETFULLY	F R EH T F AH L IY
FRISIAN	F R IH ZH IH N
FRISKING	F R IH S K IH NG
FRIVOLTY	F R IH V OW L T IY
FROLICSOME	F R AA L IH K S AH M
FRONDED	F R AA N D IH D
FROUZLY	F R AW Z L IY
FROW	F R AW
FROWST	F R AW S T
FRUITFULNESS	F R UW T F AH L N AH S
FRUMPS	F R AH M P S
FULVOUS	F UH L V AH S
FUNEREAL	F AH N IH R IY AH L
FURRED	F ER D
FURROWS	F ER OW Z
FUTURITY	F Y UW CH UH R AH T IY
GALVANO	G AA L V AA N OW
GAPES	G EY P S
GARDAFUI	G AA R D AA F UW IY
GARFISH	G AA R F IH SH
GAZERS	G EY Z ER Z
GENERALISATION	JH EH N R AH L IH Z EY SH AH N
GENERALISATIONS	JH EH N R AH L IH Z EY SH AH N Z
GENERALISE	JH EH N R AH L IH Z
GENTS	JH AH N T S
GEOLOGICALLY	JH IY AH L AA JH IH K L IY
GERMAINS	JH ER M EY N Z
GESINE	JH EH S IY N IY
GESTICULATED	G AH S T IH K Y AH L EY T IH D
GHERKINS	G ER K IH N Z
GIGANTEA	G IH G AH N T IY AH
GILIAS	JH IY L IY AH Z
GILLYFLOWERS	G IH L IH F L AW ER Z
GLADDENED	G L AE D AH N D
GLINTS	G L IH N T S
GLORIED	G L AO R IY D
GLUESOME	G L UW S AH M
GNOSTIC	N AA S T IH K
GODOLPHIN	G AH D OW L F AH N
GOOSE'S	G UW S IH Z
GORINGE	G AO R IH N JH
GRACILITY	G R EY S IH L AH T IY
GRAHAME	G R EY AH M EY
GRAMMARS	G R AE M ER Z
GRANTER	G R AE N T ER
GRAPNELS	G R AE P N AH L Z
GRASSHOPPER'S	G R AE S HH AA P ER Z
GRAVELLED	G R AE V AH L D
GREENY	G R IY N IY
GREYISH	G R EY IH SH
GUILLEMOTS	G IH L AH M AA T S
GULLIBY	G AH L IH B IY
GUMMERY	G AH M ER IY
HAIMAIRES	HH EY M EH R Z
HANDSOMER	HH AE N S AH M ER
HANDSOMEST	HH AE N S AH M EH S T
HANRAHAN'S	HH AE N R AH HH AE N Z
HARDICANUTES	HH AA R D IH K AH N AH T S
HARMONISED	HH AA R M AH N IH Z D
HARTEBEEST	HH AA R T IH B IH S T
HATLESS	HH AE T L AH S
HAUNCHES	HH AO N CH IH Z
HEADLANDS	HH EH D L AH N D Z
HEAVENWARD	HH EH V AH N W ER D
HEBREWS	HH EH B R UW Z
HEDGEROWS	HH EH JH ER AW Z
HEEDLESS	HH IY D L AH S
HEMISPHERES	HH EH M AH S F IH R Z
HENCEFORWARD	HH EH N S F AO R W ER D
HESCHHATE	HH EH SH HH EY T
HIBERNIAN	HH AY B ER N IY AH N
HIJJUS	HH AY JH JH AH S
HILAIRE	HH IH L EH R
HIPPARCHUS	HH IH P ER CH AH S
HOBBISM	HH AA B IH Z AH M
HOMELINESS	HH OW M L IY N AH S
HOMEWARDS	HH OW M W ER D Z
HONOROF	AA N ER AA F
HONOUR	AA N AW R
HONOURABLE	AA N ER AH B AH L
HONOURABLY	AA N ER AH B L IY
HONOURS	AA N UH R Z
HORNPIPES	HH AO R N P AY P S
HORTENSIA	HH AO R T EH N S IY AH
HORTENSIA'S	HH AO R T EH N SH AH Z
HOSPITABLY	HH AA S P AH T AH B L IY
HOWS	HH AW Z
HOWSOEVER	HH AW S OW EH V ER
HULLO	HH UW L OW
HUMMED	HH AH M D
HUMOUR	HH Y UW M ER
HUMOURS	HH Y UW M AO R Z
HUMPHED	HH AH M F T
HURLBUT'S	HH ER L B AH T S
HURRAHS	HH ER AH Z
HYBERBOREAN	HH AY B ER B AO R IY AH N
HYDROPHOBIA	HH AY D R AH F OW B IY AH
HYDROSTATICS	HH AY D R OW S T AE T IH K S
HYPOS	HH AY P OW Z
HYPOTHESI	HH AY P AH TH EH S IY
IGNORABIMUS	IH G N ER AE B IH M AH S
IGNORANTLY	IH G N ER AH N T L IY
ILLIMITABLE	IH L IH M AH T AH B AH L
IMAGINABLY	IH M AE JH AH N AH B L IY
IMBRICATED	IH M B R IH K EY T IH D
IMMUTABILITY	IH M Y UW T AH B IH L AH T IY
IMPENETRABILITY	IH M P EH N AH T R AH B IH L AH T IY
IMPERIOUSLY	IH M P IH R IY AH S L IY
IMPERISHABLE	IH M P EH R IH SH AH B AH L
IMPETUOSITY	IH M P EH CH UW AA S IH T IY
IMPORTUNATE	IH M P AO R CH AH N AH T
IMPRESSIVENESS	IH M P R EH S IH V N AH S
INAPTLY	IH N AE P T L IY
INCOG	IH N K AO G
INCONSIDERABLE	IH N K AH N S IH D ER AH B AH L
INCONSOLABLE	IH N K AH N S AA L AH B AH L
INDIFFERENTLY	IH N D IH F R AH N T L IY
INDISCREETLY	IH N D IH S K R IY T L IY
INDISTINCTNESS	IH N D IH S T IH NG K N AH S
INDIVIDUALISED	IH N D AH V IH JH UW AH L IH Z D
INDIVIDUALITIES	IH N D AH V IH JH UW AE L AH T IY Z
INDIVISIBILITY	IH N D IH V IH Z AH B IH L AH T IY
INDUBITABLE	IH D UW B IH T AH B AH L
INDUBITABLY	IH D UW B IH T AH B L IY
INDUCTIONS	IH N D AH K SH AH N Z
INDUCTIVE	IH N D AH K T IH V
INEXPERT	IH N IH K S P ER T
INFALLIBLY	IH N F AE L AH B L IY
INFANTINE	IH N F AE N T IY N
INFINITESIMALLY	IH N F IH N IH T EH S AH M AH L IY
INGENERABLE	IH N JH EH N ER AH B AH L
INIQUITOUS	IH N IH K W IH T AH S
INITIALIZATION	IH N IH SH AH L IH Z EY SH AH N
INLANDERS	IH N L AH N D ER Z
INMOST	IH N M OW S T
INPUTTING	IH N P UH T IH NG
INQUIRERS	IH N K W AY ER ER Z
INSERTIONS	IH N S ER SH AH N Z
INSINUATINGLY	IH N S IH N Y UW EY T IH NG L IY
INSTANTS	IH N S T AH N T S
INSTAURATORS	IH N S T AO R AH T ER Z
INSTEP	IH N S T EH P
INTERATOMIC	IH N T ER AH T AA M IH K
INTERBLENDED	IH N T ER B L EH N D IH D
INTERCOMMUNICATION	IH N T ER K AH M Y UW N AH K EY SH AH N
INTERMEDIATION	IH N T ER M IY D IY EY SH AH N
INTREPIDITY	IH N T R EH P IH D IH T IY
INVENIENDI	IH N V IY N Y AH N D IY
INVERTIBLE	IH N V ER T AH B AH L
INVITINGLY	IH N V AY T IH NG L IY
INVOLUTION	IH N V AH L UW SH AH N
IONIAN	AY OW N IY AH N
IRREFRAGABLE	IH R AH F R AE G AH B AH L
IRREPRESSIBLY	IH R AH P R AH S AH B L IY
IRRESOLUTE	IH R EH Z AH L UW T
ISOMERIC	AY S OW M EH R IH K
ISRAELITES'	IH Z R EY L IY T S
JASPAR	JH AE S P ER
JEANNE'S	JH IY N Z
JEERINGLY	JH IH R IH NG L IY
JETSAM	JH EH T S AH M
JOCKEY'S	JH AA K IY Z
JOLIFFE	ZH AA L IH F
JOLIFFE'S	ZH AA L IH F S
JOLIFFES	ZH AA L IH F S
JOVE	JH OW V IY
JOYLESS	JH OY L IH S
JR	JH R
JUBILANTLY	JH UW B AH L AH N T L IY
JUDGMATICALLY	JH AH JH M AE T IH K L IY
JUMPSOME	JH AH M P S AH M
JUSSIEU	JH UW S IY UW
KALEIDOSCOPIC	K AH L AY D AH S K AA P IH K
KAWEAH	K AA V EH AH
KEENNESS	K IY N N AH S
KELLET	K EH L AH T
KELLYNCH	K EH L IH N CH
KEPLER'S	K EH P L ER Z
KERFOOT'S	K ER F UH T S
KEYTAL	K EY T AH L
KHAMA'S	K AA M AH Z
KICKIN'	K IH K IH N
KNEELED	N IY L D
KNIFE'S	N AY F S
KOLOKOLO	K AA L AH K OW L OW
KOODOO	K UW D UW
KYUR	K Y UH R
LAMARCK	L AA M AA R K
LAMBERTIANA	L AE M B ER T IY AA N AH
LANCASTER'S	L AE NG K AE S T ER Z
LANCES	L AE N S IH Z
LANDAULETTE	L AE N D AO L EH T
LANDSMEN	L AE N D Z M IH N
LANGIER	L AE N JH IY ER
LANGUIDLY	L AE NG G W AH D L IY
LANTERN'S	L AE N T ER N Z
LAPLACE	L AH P L EY S
LARKSPURS	L AA R K S P ER Z
LAROLLES	L AA R OW L Z
LAVOISIER	L AH V W AA Z IY ER
LAWFULNESS	L AO F AH L N AH S
LAYIN'	L EY IH N
LEAFIEST	L IY F IY AH S T
LEIBNITZ	L IY B N IH T S
LENDETH	L EH N D IH TH
LEOPARD'S	L EH P ER D Z
LEPPED	L EH P T
LESQUEREUX	L EH S K ER OW
LEVELLING	L EH V AH L IH NG
LIARD	L IY ER D
LIBOCEDRUS	L IH B OW S EY D R AH S
LIBRIVOX	L AY B R AH V AA K S
LIEBIG'S	L IY B IH G Z
LIEUTENANT'S	L UW T EH N AH N T S
LIMPID	L IH M P IH D
LIMPOPO	L IH M P OW P OW
LINNAEUS	L IH N IY AH S
LIPPERTY	L IH P ER T IY
LITHELY	L IH TH L IY
LITTLENESS	L IH T AH L N AH S
LIZY	L IY Z IY
LOANGA	L OW NG G AH
LOFTING	L AA F T IH NG
LOGGIN'	L AA G IH N
LOGIN	L OW JH IH N
LOLLOPING	L AA L AH P IH NG
LONVILLE	L OW N V IH L
LOOKEST	L UH K AH S T
LOOMINGS	L UW M IH NG Z
LORDING	L AO R D IH NG
LOUISA'S	L UW IY Z AH Z
LOVELINESS	L AH V L IY N AH S
LUMBERMEN	L AH M B ER M AH N
LUPINES	L UW P AY N Z
LUSTILY	L AH S T AH L IY
LYELL'S	L AY EH L Z
LYNCEI	L IH N CH EY IY
MACKEREEL	M AE K ER IY L
MACROCOSM	M AE K R AH K AA Z M
MAGICIAN'S	M AH JH IH SH AH N Z
MAGICS	M AE JH IH K S
MAGNETE	M AE G N EH T
MAGNETO	M AE G N EH T OW
MAGNIFICA	M AE G N IH F IH K AH
MAGNIFICENCE	M AE G N AH F AH S AH N S
MAKETH	M AE K IH TH
MALPIGHI	M AE L P AH G IY
MAMMA'S	M AE M AH Z
MANHATTO	M AE N HH AE T OW
MANHATTOES	M AE N HH AE T OW Z
MANOEUVRED	M AE N ER V D
MANZANITA	M AE N Z EY N IY T AH
MARALDI	M AA R AA L D IY
MARBRE	M AA R B ER
MARINER'S	M ER IY N ER Z
MARQUISETTE	M AA R K W AH Z EH T
MARVELLOUS	M AA R V AH L AH S
MARVELLOUSLY	M AA R V AH L AH S L IY
MASSY	M AE S IY
MATERIA	M AH T IH R IY AH
MATTERLESS	M AE T ER L AH S
MAUVAIS	M OW V EY
MAZANDERAN	M AH Z AE N D ER AH N
MAZARIN	M AA Z AA R IH N
MAZY	M EY Z IY
MCFEE'S	M AH K F IY Z
MEAGRE	M IY G ER
MECHANICIAN	M AH K AE N IH SH AH N
MECHANICIANS	M AH K AE N IH SH AH N Z
MEDIAEVAL	M IY D IY AH EH V AH L
MEETIN'	M IY T IH N
MEGARA	M EH G AA R AH
MELLONI	M EH L OW N IY
MERIDIANS	M EH R IH D IY AH N Z
METHYE	M EH TH AY
MIGNONETTE	M IY G N OW N EH T
MILLINERY	M IH L IH N ER IY
MILLTOWN	M IH L T AW N
MINOS	M IH N OW Z
MINUTENESS	M IH N AH T N AH S
MINUTEST	M IH N AH T AH S T
MISAPPREHENDED	M IH S AH P R IH HH EH N D IH D
MISRECKONING	M IH S R EH K AH N IH NG
MLLE	M L
MME	M
MOJOMOVE	M OW JH OW M UW V
MOLAR	M OW L ER
MOLE'S	M OW L Z
MOLOCH	M AA L AH K
MOLUCCAS	M OW L UW K AH S
MONARCHICAL	M AA N AA R K AH K AH L
MONISTIC	M AH N IH S T IH K
MONKFORD	M AH NG K F ER D
MONOPOLISING	M AH N AA P AH L IH Z IH NG
MONOS	M AA N AH Z
MONOSYLLABIC	M AA N AH S AH L AE B IH K
MOORHENS	M UH R HH EH N Z
MORAINES	M ER EY N Z
MORNIN'	M AO N IH N
MORTIFICATION	M AO R T AH F AH K EY SH AH N
MOTHERWIT	M AH DH ER W IH T
MOTTLE	M AA T AH L
MOUTHFULS	M AW TH F AH L Z
MUELLER'S	M Y UW L ER Z
MUSGROVE'S	M AH S G R AH V Z
MUSGROVES	M AH S G R AH V Z
MUSKETOONS	M AH S K AH T UW N Z
MUSLINS	M AH Z L AH N Z
MUTTONEERS	M AH T AH N IH R Z
MYRIADS	M IH R IY AH D Z
NAKATA'S	N AA K AA T AH Z
NAKEDNESS	N EY K AH D N AH S
NARCISSUS'S	N AA R S IH S IH Z IH Z
NARROWMINDED	N EH R OW M AY N D IH D
NASTURTIUMS	N AE S T UH R SH Y AH M Z
NATUR	N AE CH ER
NAUGHTINESS	N AO T IY N AH S
NEBULAE	N EH B Y AH L EY
NEBULAR	N EH B Y AH L ER
NEEDETH	N IY D IH TH
NEIGHBOURHOOD	N EY B AO R HH UH D
NEIGHBOURING	N EY B ER IH NG
NEIGHBOURS	N EY B AO R Z
NEILSON'S	N IY L S AH N Z
NEUTRALISED	N UW T R AH L IH Z D
NEWSKI	N UW S K IY
NIGHTGLOW	N AY T G L OW
NISUS	N IH Z AH S
NOBLENESS	N OW B AH L N AH S
NONTRIVIAL	N AA N T R IH V Y AH L
NOONDAY	N UW N D EY
NORMANS	N AO R M AH N Z
NORTHEASTER	N AO R TH IY S T ER
NORTHMEN	N AO R TH M EH N
NORTHWARDS	N AO R TH W ER D Z
NOSEGAY	N OW Z IH G EY
NOTATIONAL	N OW T EY SH AH N AH L
NOTEPAD	N OW T P AE D
NOUVEAUX	N UW V OW
NUBBLY	N AH B L IY
NUMBERLESS	N AH M B ER L AH S
NURSEY	N ER S IY
NUTRIMENT	N UW T R AH M AH N T
OBLIGETH	AH B L AY JH IH TH
OBSERVATIONAL	AH B Z ER V EY SH AH N AH L
OBSERVEST	AH B Z ER V EH S T
OBTUSA	AA B T UW S AH
OCCURED	AH K ER D
OERSTED	AO R S T AH D
OFFCHANCE	AH F K AE N S
OILSKINS	OY L S K IH N Z
OK'D	OW K D
OLDNAME	OW L D N EY M
OMNE	AA M N
OO	UW
OPERAND	AA P R AH N D
OPERANDS	AA P R AH N D Z
OPTIMIZED	AA P T AH M AY Z D
ORANGEMEN	AO R IH N JH M AH N
ORDERETH	AO R D ER IH TH
ORGANDIE	AO R G AE N D IY
ORGANISE	AO R G AH N IH Z
ORGANISED	AO R G AH N IH Z D
OROTAVO	AO R OW T AA V OW
OSSIAN	AA S ZH IH N
OURANOGRAPHY	OW UH R AH N AA G R AH F IY
OUTPORTS	AW T P AO R T S
OUTSPREAD	AW T S P R EH D
OUTSWEEPING	AW T S W IY P IH NG
OVERSEWING	OW V ER S OW IH NG
OVO	OW V OW
PACHYDERM	P AH HH AY D ER M
PALAEONTOLOGY	P AH L IY AH N T AA L AH JH IY
PALAETIOLOGICAL	P AH L IY T IY AH L AA JH IH K AH L
PALAVER	P AE L AH V ER
PALSIED	P AO L Z IY D
PANEGYRIC	P AE N AH JH IH R IH K
PAPISTS	P AH P IH S T S
PARALLELOGRAM	P EH R AH L EH L AH G R AE M
PARALYSED	P ER AE L AH S T
PARALYSES	P ER AE L AH S IY Z
PARASITISM	P EH R IH S IH T IH Z AH M
PARASOL	P EH R IH S AO L
PARASOLS	P EH R IH S AO L Z
PARCHING	P AA R CH IH NG
PARDONABLE	P AA R D OW N AH B AH L
PARSEE	P AA R S IY
PARSEE'S	P AA R S IY Z
PARTIALITIES	P AA R SH IY AE L AH T IY Z
PARVUM	P AA R V AH M
PASCAL'S	P AA S K AH L Z
PASSEMENTERIE	P AE S AH M EH N T ER IY
PASSPHRASE	P AE S F R EY Z
PAUTE	P AW T
PDA	P D AH
PEARCE'S	P ER S IH Z
PENETRALIA	P EH N AH T R EY L Y AH
PENKNIFE	P EH NG N AY F
PENTATEUCHAL	P EH N T AH T EY AH CH AH L
PERAMBULATOR	P ER AE M B Y AH L EY T ER
PERCEPTIBILITY	P ER S EH P T IH B IH L AH T IY
PERDITION	P ER D IH SH AH N
PERMITTETH	P ER M IH T IH TH
PERPENDICULARLY	P ER P AH N D IH K Y AH L ER L IY
PERSONAGE	P ER S AH N IH JH
PERSPICACITY	P ER S P IH K AE S AH T IY
PERVIOUS	P ER V IY AH S
PESTILENCES	P EH S T AH L AH N S IH Z
PESTILENT	P EH S T AH L AH N T
PETTISHLY	P EH T IH SH L IY
PFEIFFERS	F AY F ER Z
PHANEROGAMS	F EY N ER AA G AH M Z
PHILOSOPHIE	F IH L AH S AA F IY
PHILOZOIC	F IH L AH Z OW IH K
PHLOX	F L AA K S
PHP	F P
PHYSICO	F IH Z IH K OW
PHYSIOLOGISTS	F IH Z IY AA L AH JH IH S T S
PICKEREEL	P IH K ER IY L
PICS	P IH K S
PICTURESQUELY	P IH K CH ER AH S K L IY
PICTURESQUENESS	P IH K CH ER AH S K N IH S
PIGWEED	P IH G W IY D
PINNATE	P IH N EY T
PINNATED	P IH N EY T IH D
PINUS	P AY N AH S
PIPELINING	P AY P L AY N IH NG
PIS	P IH S
PITILESSLY	P IH T AH L AH S L IY
PLAICE	P L AH S
PLATEAUS	P L AE T OW Z
PLATEFUL	P L EY T F AH L
PLEASANTEST	P L EH Z AH N T AH S T
PLUMPING	P L AH M P IH NG
PLUMY	P L UW M IY
PLUSHY	P L AH SH IY
POHONO	P OW HH AH N OW
PONDERABLE	P AA N D ER AH B AH L
POOHPOOH	P UW P UW
POPERY	P AA P ER IY
POPLARS	P AA P L ER Z
PORTHOLE	P AO R T HH OW L
PORTULACA	P AO R CH UW L AE K AH
POSTERN	P OW S T ER N
POTENTIALITY	P AH T EH N SH IY AE L AH T IY
POTTAGE	P AA T IH JH
POULETT	P UW L EH T
POWERPOINT	P AW ER P OY N T
PRACTICABILITY	P R AE K T AH K AH B IH L AH T IY
PRACTISED	P R AE K T AY Z D
PRAETORS	P R IY T ER Z
PRANCED	P R AE N S T
PREBENDARY	P R EH B AH N D EH R IY
PRECIPICES	P R IH S IH P AH S IH Z
PREFATORY	P R EH F AH T AO R IY
PREPROCESSED	P R IY P R AO S EH S T
PRESCRIBETH	P R IY S K R AY B IH TH
PRHOTE	P R HH OW T
PRICKING	P R IH K IH NG
PRICKLES	P R IH K AH L Z
PRINCIPES	P R IH N S AH P IY Z
PROCURATION	P R OW K Y UH R EY SH AH N
PRODUCIBLE	P R AH D UW S AH B AH L
PROMISINGLY	P R AH M AY Z IH NG L IY
PROMONTORIES	P R AH M OW N T AO R IY Z
PROMOTER'S	P R AH M OW T ER Z
PROMULGATION	P R AA M AH L G EY SH AH N
PROPELLE	P R AH P EH L
PROPEREST	P R AA P ER IH S T
PROPHESY	P R AA F AH S IY
PROPHESYING	P R AA F AH S IY IH NG
PROPOS	P R AH P OW Z
PROPOSITIONAL	P R AH P OW Z IH SH AH N AH L
PROSELYTES	P R AA S AH L AH T S
PROTESTETH	P R OW T EH S T IH TH
PROTOGAEA	P R OW T AH G IY AH
PROTOPLASM	P R OW T AH P L AE Z AH M
PROVENDER	P R OW V EH N D ER
PROVOCATEURS	P R OW V AA K AH T ER Z
PROWLED	P R AW L D
PSEUDOTSUGA	S UW D AH T S UW G AH
PUGILISTS	P Y UW JH AH L IH S T S
PULPY	P UH L P IY
PUNCHAYET	P AH N CH AY EH T
PUNTING	P AH N T IH NG
PUTREFYING	P AH T R AH F AY IH NG
QB	K B
QUAGGA	K W AE G AH
QUENCHED	K W EH N CH T
QUITTED	K W IH T IH D
RACOONS	R EY S UW N Z
RADIOMETER	R EY D IY AA M IH T ER
RAMIFYING	R AE M AH F AY IH NG
RANDALL'S	R AE N D AH L Z
RANDOLPHS	R AE N D OW L F S
RAPACITY	R AH P AE S AH T IY
RAPTURES	R AE P CH ER Z
RATIOCINATION	R AE SH S AH N EY SH AH N
RATS'	R AE T S
REALISATION	R IY AH L IH Z EY SH AH N
REALISE	R IY AH L IH Z
REALISED	R IY AH L IH Z D
REALISING	R IY AH L IH Z IH NG
REASONEST	R IY Z AH N AH S T
REASONINGS	R IY Z AH N IH NG Z
REBELLIOUSLY	R IH B EH L IY AH S L IY
RECAMIER	R IY K EY M Y ER
RECOGNISED	R EH K AH G N AY Z D
RECOGNIZER	R EH K AH G N AY Z ER
RECOMMENCED	R IY K AH M EH N S T
RECOMMENCING	R IY K AH M EH N S IH NG
RECTILINEAR	R EH K T IH L IH N IY ER
REDDENING	R EH D N IH NG
REDDY'S	R EH D IY Z
REDLINE	R EH D L AY N
REDLINED	R EH D L AY N D
REEXTEND	R IY EH K S T EH N D
REFLECTIVELY	R IH F L EH K T IH V L IY
REFLECTIVITY	R IH F L EH K T IH V AH T IY
REFRACTION	R AH F R AE K SH AH N
REIGNERS	R EY N ER Z
REJOICES	R IY JH OY S IH Z
RELINQUISHMENT	R IY L IH NG K W IH SH M AH N T
RENSSELAERS	R EH N S AH L IH R Z
REPERUSAL	R IY P ER UW Z AH L
REPOSING	R IY P AH Z IH NG
REPREHENDED	R EH P R IH HH EH N D IH D
REPRESENTER	R EH P R AH Z EH N T ER
REPRESENTETH	R EH P R AH Z EH N T IH TH
REPROACHFULLY	R IY P R OW CH F AH L IY
REPROOF	R IY P R UW F
REPULSION	R IY P AH L SH AH N
REQUITED	R IY K W AY T IH D
RESCORING	R EH S K AO R IH NG
RESINOUS	R EH Z AH N AH S
RESINY	R IH Z AY N IY
RESOUNDED	R IY S AW N D IH D
RESPECTER	R IY S P EH K T ER
RETENTIVE	R IY T EH N T IH V
RETINOSPORA	R EH T IY N OW S P AO R AH
RETRANSMITTED	R IY T R AE N S M IH T IH D
REVENGING	R EH V AH N JH IH NG
REVERENTIALLY	R IH V ER EH N CH AH L IY
REVICTUAL	R IY V AY K CH UW AH L
REVOLUTIONISED	R EH V AH L UW SH AH N IH Z D
RHINOCEROS'S	R AY N AA S ER OW S IH Z
RIFTED	R IH F T IH D
RIGOUR	R IH G AO R
RIPER	R AY P ER
RIVERBORO	R AY V ER B ER OW
ROADBED	R AO D B D
ROADMATE	R OW D M EY T
ROEBUCKS	R OW B AH K S
ROOTLET	R UW T L AH T
ROSETTED	R AH S EH T IH D
ROSETTING	R AH S EH T IH NG
ROUE	R UW
ROVIN'	R OW V IH N
ROWENA'S	R OW IY N AH Z
ROWLOCKS	R OW L AA K S
RUBAGUB	R UW B AH G AH B
RUMFORD'S	R AH M F ER D Z
RUMINANTS	R UW M AH N AH N T S
RUMPUS	R AH M P AH S
RYO	R AY OW
S'POSE	S IH P OW Z
SABINIANA	S AA B IY N IY AA N AH
SAGACIOUS	S AE G EY SH AH S
SAGACITY	S AH G AE S AH T IY
SAITH	S EY TH
SALLOW	S AE L OW
SAMOYEDES	S AH M OY D IY Z
SANCROFT	S AE NG K R AO F T
SANDIEST	S AE N D IY AH S T
SARAI	S AA R AA IY
SARAI'S	S AA R AY Z
SARCODES	S AA R K OW D Z
SASHLESS	S AE SH L AH S
SATIABLE	S AE T AY AH B AH L
SATIATED	S EY SH IY EY T IH D
SAUL'S	S AO L Z
SAUNTERING	S AO N T ER IH NG
SAVOUR	S AH V AW ER
SAVOURY	S AH V AO R IY
SCABIES	S K AE B IY Z
SCALESOME	S K EY L S AH M
SCEPTICAL	S EH P T IH K AH L
SCHEMATISM	S K EH M AH T IH Z AH M
SCHLOOP	SH L UW P
SCHLOOPED	SH L UW P T
SCHLOOPY	SH L UW P IY
SCHWANN	SH W AA N
SCIENTIAS	S AY AH N T AY AH S
SCLUSIVELY	S K L UW S IH V L IY
SCLUSIVEST	S K L UW S IH V EH S T
SCOFFER	S K AO F ER
SCORBUTIC	S K AO R B Y UW T IH K
SCOTCHWOMAN	S K AA CH W UH M AH N
SCRABBLED	S K R AE B AH L D
SCREENSHOTS	S K R IY N SH AA T S
SCROOGED	S K R UW JH D
SCROPE	S K R OW P
SCRUCIATING	S K R UW SH IY EY T IH NG
SCRUCIATINGLY	S K R UW SH IY EY T IH NG L IY
SCUDDING	S K AH D IH NG
SCULLED	S K AH L D
SCULLING	S K AH L IH NG
SCULLS	S K AH L Z
SCUSE	S K Y UW Z
SEAFARING	S IY F EH R IH NG
SEDGES	S EH JH IH Z
SELDEN'S	S EH L D AH N Z
SELECTMAN	S AH L EH K T M AH N
SELENOGRAPHIC	S EH L EH N AH G R AE F IH K
SELLETH	S EH L IH TH
SELVAS	S EH L V AH Z
SEMPERVIRENS	S EH M P ER V IH R AH N Z
SEPARABLE	S EH P ER AH B AH L
SESSILE	S EH S AH L
SEXTANT	S EH K S T AH N T
SHADIEST	SH EY D IY AH S T
SHAFTESBURY	SH AE F T Z B EH R IY
SHALLENBERG	SH AE L AH N B ER G
SHAMPOOING	SH AE M P UW IH NG
SHAN'T	SH AE N T
SHEEPMEN	SH IY P M AH N
SHEWED	SH UW D
SHEWN	SH UW N
SHIMMERINGLY	SH IH M ER IH NG L IY
SHIPWRECKED	SH IH P R EH K T
SHIVERINGS	SH AY V ER IH NG Z
SHOVELFULS	SH AH V AH L F AH L Z
SHREWS	SH R UW Z
SHRIMPS	SH R IH M P S
SHRIVELLED	SH R IH V EH L D
SIDEBOARDS	S AY D B AO R D Z
SILICIOUS	S IH L IH SH AH S
SILVERED	S IH L V ER D
SILVERING	S IH L V ER IH NG
SIMILITUDE	S IH M IH L AH T UW D
SIXPENCE	S IH K S P EH N S
SKILFUL	S K IH L F AH L
SKILFULLY	S K IH L F AH L IY
SKITTER	S K IH T ER
SLANDERERS	S L AE N D ER ER Z
SLATY	S L EY T IY
SLAYS	S L EY Z
SLEDGES	S L EH JH IH Z
SLIDY	S L AY D IY
SLOKA	S L OW K AH
SLOPED	S L AH P T
SLOSHY	S L AA SH IY
SLUSHY	S L AH SH IY
SMARTPHONES	S M AA R T F OW N Z
SMOKEHOUSE	S M OW K HH AW S
SMOTHERY	S M AH DH ER IY
SNAKY	S N EY K IY
SNARLY	S N AA R L IY
SNIGGERING	S N IH G ER IH NG
SOCOTRA	S AA K OW T R AH
SOLDIERY	S OW L JH ER IY
SOLICITOR'S	S AH L IH S AH T ER Z
SOLICITUDES	S AH L IH S AH T UW D Z
SOLITUDES	S AA L AH T UW D Z
SOMERSETSHIRE	S AH M ER S EH T SH ER
SONAPUT	S AH N AH P UH T
SPALLANZANI	S P AE L AA N Z AA N IY
SPANGLING	S P AE NG G AH L IH NG
SPANIELS	S P AE N Y AH L Z
SPANKS	S P AE NG K S
SPECIALISED	S P EH SH AH L IH Z D
SPECKLY	S P EH K L IY
SPECTRALLY	S P EH K T R AH L IY
SPECTROSCOPIC	S P EH K T R AH S K AA P IH K
SPEKE	S P EH K IY
SPHAGNUM	S F AE G N AH M
SPICKLY	S P IH K L IY
SPILES	S P AY L Z
SPINDRIFT	S P IH N D R IH F T
SPIREA	S P IH R AH
SPIRITUOUS	S P IH R IH CH AH W AH S
SPIRY	S P AY R IY
SPITZBERGEN	S P IH T S B ER G AH N
SPLENDOUR	S P L EH N D AW R
SPLOOSH	S P L UW SH
SPLUTTERING	S P L AH T ER IH NG
SPONGING	S P AO NG IH NG
SPORTSWOMAN	S P AO R T S W UH M AH N
SPOTTLED	S P AA T AH L D
SPOUTER	S P AW T ER
SPRINGY	S P R IH N JH IY
SPROTTLED	S P R AA T AH L D
SPRUCES	S P R UW S AH Z
SQUAB	S K W AA
SQUAWS	S K W AO Z
SQUSHY	S K W SH IY
STAGS	S T AE G Z
STAMINATE	S T AE M AH N EY T
STAMMERED	S T AE M ER D
STANISLAUS	S T AE N IH S L AO Z
STARWOOD	S T AA R W UH D
STATICAL	S T AE T IH K AH L
STATICS	S T AE T IH K S
STEEPLING	S T IY P AH L IH NG
STEVINUS	S T EH V AH N IH S
STEWARD'S	S T UW ER D Z
STIES	S T AY Z
STOATS	S T OW AA T S
STRIPY	S T R AY P IY
STRONGBOW	S T R AO NG B OW
STUTE	S T UW T
SUAVITY	S W AA V AH T IY
SUBDIRECTORY	S AH B D IH R EH K T ER IY
SUBJECTION	S AH B JH EH K SH AH N
SUBLIMELY	S AH B L AY M L IY
SUBLUNARY	S AH B L AH N EH R IY
SUBSCRIPT	S AH B S K R IH P T
SUBSTRATUM	S AH B S T R AE T AH M
SUFFRAGES	S AH F R AH JH AH Z
SULTANAS	S AH L T AH N AH Z
SUMPTUARY	S AH M P CH UW EH R IY
SUNBEAMS	S AH N B IY M Z
SUNGOLD	S AH N G OW L D
SUNNYBROOK	S AH N IY B R UH K
SUPERIMPOSITION	S UW P ER AH M P OW Z IH SH AH N
SUPERINDUCE	S UW P ER IH N D UW S
SUPERINDUCEMENT	S UW P ER IH N D UW S M AH N T
SYCOPHANT	S IH K AH F AE N T
SYMBOLICAL	S IH M B AA L IH K AH L
SYRINGA	S IH R IY NG G AH
TALLISH	T AE L IH SH
TALUSES	T AE L AH S IH Z
TAPEWORMS	T EY P W ER M Z
TARES	T AA R Z
TASSELS	T AE S AH L Z
TASTILY	T EY S T AH L IY
TAXONOMIST	T AE K S AH N AA M AH S T
TEASER'S	T IY Z ER Z
TEAZE	T IY Z
TEAZING	T IY Z IH NG
TELEGRAPHY	T EH L AH G R AH F IY
TELEOLOGY	T EH L IY AA L AH JH IY
TENAYA	T EH N AY AH
TENAYA'S	T EH N AY AH Z
TERMINUS	T ER M AY N AH S
TERRAPIN	T EH R AH P IH N
THALES	TH EY L Z
THEORIE	TH IY ER IY
THERMOTICS	TH ER M AA T IH K S
THIBET	TH IH B IH T
THITHER	TH IH DH ER
THORPE'S	TH AO R P S
THRESHED	TH R EH SH T
THRIFTILY	TH R IH F T AH L IY
TICHBORNE	T IH CH B ER N
TICKLY	T IH K L IY
TIDILY	T AY D AH L IY
TINNIS	T IH N IH S
TITTAMEGS	T IH T AH M EH G Z
TOAD'S	T OW D Z
TOMFOOLERY	T AH M F UW L ER IY
TOPHET	T AA F AH T
TOPMOST	T AA P M OW S T
TOPOGRAPHICAL	T AH P AH G R AE F IH K AH L
TORRIBY	T AO R AH B IY
TOTTERED	T AA T ER D
TOURBILLONS	T ER B IH L AH N Z
TOURIST'S	T UH R IH S T S
TRANCED	T R AE N S T
TRANSMUTABILITY	T R AE N S M Y UW T AH B IH L AH T IY
TRANSMUTATION	T R AE N S M Y UW T EY SH AH N
TREVIRANUS	T R EH V AY R EY N IH S
TRICHINA	T R IH K IY N AH
TRICKLY	T R IH K L IY
TRIGLY	T R AY G L IY
TROP	T R AA P
TRUSTFUL	T R AH S T F AH L
TUBERCULATA	T UW B ER K Y AH L AH T AH
TUDORS	T UW D ER Z
TULE	T Y UW L
TULLE	T AH L
TUREEN	T ER IY N
TUSKY	T AH S K IY
TV'S	T V Z
TWIRLY	T W ER L IY
UMPQUA	AH M P K W AH
UNBAR	AH N B AA R
UNBROKE	AH N B R OW K
UNBUYABLE	AH N B AH AH B AH L
UNCEASINGLY	AH N S IY S IH NG L IY
UNCHANGEABLE	AH N CH EY N JH AH B AH L
UNCULTIVATED	AH N K AH L T AH V EY T IH D
UNCURLED	AH N K ER L D
UNDECAYED	AH N D AH K EY D
UNDELIVERABLE	AH N D IH L IH V ER AH B AH L
UNDERSTANDETH	AH N D ER S T AE N D IH TH
UNDIMMED	AH N D IH M D
UNDISTINGUISHABLE	AH N D IH S T IH NG G W IH SH AH B AH L
UNDULATORY	AH N JH AH L EY T ER IY
UNE	Y UW N
UNFASTENED	AH N F AE S AH N D
UNFREQUENTLY	AH N F R IY K W AH N T L IY
UNGRACEFUL	AH N G R EY S F AH L
UNGRACIOUS	AH N G R EY SH AH S
UNGRASPABLE	AH N G R AE S P AH B AH L
UNLAWFULNESS	AH N L AO F AH L N AH S
UNLIKENESS	AH N L AY K N AH S
UNNOTICEABLE	AH N N OW T AH S AH B AH L
UNOBTRUSIVELY	AH N AH B T R UW S IH V L IY
UNPERSUADABLE	AH N P ER S W EY D AH B AH L
UNPLANTED	AH N P L AE N T IH D
UNPRODUCTIVELY	AH N P R AH D AH K T IH V L IY
UNQUENCHABLE	AH N K W EH N CH AH B AH L
UNRESERVEDLY	AH N R IY Z ER V AH D L IY
UNRIVALLED	AH N R AY V EY L D
UNROLLED	AH N R OW L D
UNSOFTENED	AH N S AO F AH N D
UNSTEADILY	AH N S T EH D AH L IY
UNSURPASSABLE	AH N S ER P AE S AH B AH L
UNSUSPICIOUS	AH N S AH S P IH SH AH S
UNTAUGHT	AH N T AO T
UNTHOUGHT	AH N TH AO T
UNTIDILY	AH N T AY D AH L IY
UNTRIMMED	AH N T R IH M D
UNUTTERABLE	Y UW N AH T ER AH B AH L
UNWEARIED	AH N W EH R IY D
UNWHOLESOME	AH N W OW L S AH M
UNWINDINGS	AH N W AY N D IH NG Z
UPHEAVED	AH P HH IY V D
UPLOADED	AH P L OW D IH D
UPPERCROSS	AH P ER K R AO S
UPTURNED	AH P T ER N D
UPTURNING	AH P T ER N IH NG
URSTOFF	ER S T AO F
USABILITY	Y UW S AH B IH L AH T IY
USERNAME	Y UW Z ER N EY M
USQUEBAUGH	Y UW S K W EH B AO
VAIR	V EH R
VALENCIENNES	V AE L AH N S IY EH N Z
VALENCY	V AE L AH N S IY
VAPORISED	V EY P ER AY Z D
VATICINATIONS	V AE T AH S AH N EY SH AH N Z
VELDT	V EH L T
VENDEUSE	V EH N D UW S
VENDIBLE	V EH N D AH B AH L
VERATRUMALBA	V EH R AH T R AH M AE L B AH
VERDURE	V ER D UH R
VET'S	V EH T S
VICTUALLING	V IH K SH AH L IH NG
VIOL	V AY AH L
VISCOUNTESS	V IH S K AW N T IH S
VITIATE	V IH SH IY EY T
VIVACITY	V IY V AE S AH T IY
VIVUM	V IY V AH M
VIZ	V IY Z
VOIE	V W AA
VOLTAIC	V OW L T EY IH K
VORTICES	V AO R T IH S IH Z
VOSSIUS	V AO S IY AH S
VOTARIES	V OW T ER IY Z
VOTETH	V OW T IH TH
VOXFORGE	V AA K S F AO R JH
VOYCE	V OY S
VOYD	V OY D
VULGARIAN	V AH L G EH R IY AH N
VULGARIANS	V AH L G EH R IY AH N Z
WABBLE	W AE B AH L
WADDLED	W AA D AH L D
WAGGLED	W AE G AH L D
WAKED	W EY K T
WALLIS'S	W AO L IH S IH Z
WAPITIS	W AH P IY T IH S
WASHIN'	W AA SH IH N
WATCHFULNESS	W AA CH F AH L N AH S
WATERCOURSES	W AO T ER K AO R S IH Z
WATERWARD	W AO T ER W ER D
WAVEFORM	W EY V F AO R M
WEIRS	W IH R Z
WENS	W EH N Z
WENTWORTH'S	W EH N T W ER TH S
WHALEMEN	HH W EY L AH M EH N
WHARVES	W AO R V Z
WHEEDLED	W IY D AH L D
WHEREFORE	HH W EH R F AO R
WHEREOF	HH W EH R AH V
WHEREON	HH W EH R AO N
WHERES	HH W EH R Z
WHEWELL	HH W EH W EH L
WHEWELL'S	HH W EH W EH L Z
WHIRLY	HH W ER L IY
WHISKING	HH W IH S K IH NG
WHITEWASHING	W AY T W AA SH IH NG
WHORLED	HH W AO R L D
WHOSO	HH UW S OW
WIGWAMS	W IH G W AA M Z
WINTERING	W IH N T ER IH NG
WISPS	W IH S P S
WITHALL	W IH TH AH L
WOLMSLEY	W AA L M Z L IY
WOLVERENES	W UH L V ER IY N Z
WOLVERINES	W UH L V ER IY N Z
WOODBINE	W UH D B AY N
WRETCHEDNESS	R EH CH IH D N AH S
WRIGGLING	R IH G AH L IH NG
YANGTSE	Y AE NG K T S
YARLY	Y AA R L IY
YOSEMITES	Y OW S EH M AY T S
ZAMBESI	Z AA M B EH S IY
ZOOELOGY	Z UW L AH JH IY
ZOOLOGIQUE	Z OW AA L AH JH IY K
