aaluu	aa l uu
aam	aa m
aanguur	aa n g uu r
aawanlaa	aa n w aa l aa
adarak	a d r a k
alsii	a l s ii
amaruud	a m r uu d
anaar	a n aa r
arahardaal	a r h a r d aa l
araharphalii	a r h a r ph a l ii
arandxiikaateel	a r a n dx ii k aa t ee l
arandxiikeebiij	a r a n dx ii k ee b ii j
baansjhaadxq	b aa n s jh aa dxq
badaamteel	b d aa m t ee l
bandagobhii	b a n d k o b ii
barabatxii	b a r b a tx ii
beengan	b ee n g a n
beent	b ee n t
beer	b ee r
beermo	b ee r m o
beesan	b ee s a n
bhindxii	bh i n dx ii
bhutxtxaa	bh u tx tx aa
biins	b ii n s
biitx	b ii tx
bodii	b o d ii
bokaaro	b o k aa r o
caakulyaa	c aa k u l y aa
caas	c aa s
caawal	c aa w a l
caay	c aa y
caaybaasaa	c aa y b aa s aa
cameelii	c a m ee l ii
canaa	c a n aa
catraa	c a t r aa
ciinii	c ii n ii
cukandar	c u k a n d a r
deewghar	d ee w gh a r
dhaan	dh aa n
dhanbaad	dh a n b aa d
dhaniyaa	dh a n i y aa
dhaniyaapattaa	dh a n i y aa p a t t aa
dhaniyaapattii	dh a n i y aa p a t t ii
dumkaa	d u m k aa
dxaaldxaa	dx aa l dx aa
dxaaltxeenganj	dx aa l tx ee n g a n j
dxeeliyaa	dx ee l i y aa
gaajar	g aa j a r
gaantxhgobhii	g aa n txh k o b ii
gadxqwaa	g a dxq w aa
gannaa	g a n n aa
geehuun	g ee h uu n
geendaaphuul	g ee n d aa ph uu l
ghii	gh ii
giridxqii	g i r i dxq ii
gleidxeeyas	g l ei dx ee y a s
gleidxeeyasgaachii	g l ei dx ee y a s g aa ch ii
godxdxaa	 g o dx dx aa
golkii	g o l k ii
gulaab	g u l aa b
gumlaa	g u m l aa
gwaarphalii	g w aa r ph a l ii
gwaarphaliikeebiij	g w aa r ph a l ii k ee b ii j
haldii	h a l d ii
haraaaam	h a r aa aa m
haraadhaniyaa	h a r aa dh a n i y aa
haraakeelaa	h a r aa k ee l aa
haraamircaa	h a r aa m i r c aa
hariimirc	h a r ii m i r c
hariimuung	h a r ii m uu n g
hariimuungdaal	h a r ii m uu n g d aa l
hazaariibaag	h a z aa r ii b aa g
imalii	i m l ii
imaliikeebiij	i m l ii k ee b ii j
jaamtaadxqaa	j aa m t aa dxq aa
jaamun	j aa m u n
jamsheedpur	j a m sh ee d p u r
jarbeeraa	j a r b ee r aa
jhiingaa	jh ii n g aa
jowaar	j o w aa r
kaabuliicanaa	k aa b u l ii c a n aa
kaalaacanaa	k aa l aa c a n aa
kaaliimirc	k aa l ii m i r c
kaccaaaam	k a c c aa aa m
kaccaakeela	k a c c aa k ee l aa
kaccaapapiitaa	k a c c aa p a p ii t aa
kaddu	k a d d uu
kadxqwaateel	k a dxq w aa t ee l
kakadxqii	k a k a dxq ii
kamalkakadxqii	k a m a l k a k a dxq ii
kamalphuul	k a m a l ph uu l
kapaas	k a p aa s
kareelaa	k a r ee l aa
kareelii	k a r ee l ii
katxhal	k a tx h a l
keelaa	k ee l aa
kharbuujaa	kh a r b uu j aa
khiiraa	kh ii r aa
khuntxii	kh u n tx ii
kodxarmaa	k o dx a r m aa
konhadxqaa	k o n h dxq aa
kundaruu	k u n d r uu
kurathiidaal	k u r th ii d aa l
laalmirc	l aa l m i r c
laateehaar	l aa t ee h aa r
laau	l aa u
lahasun	l a h s u n
lakdxqii	l a k a dxq ii
liicii	l ii c ii
lilii	l i l ii
lobiyaa	l o b i y aa
lohardaggaa	l o h a r d a g g aa
loukii	l ou k ii
madhupur	m a dh u p u r
madxquaa	m a dxq u aa
mahuaa	m a h u aa
mahuaakeebiij	m a h u aa k ee b ii j
makaii	m a k a ii
masharuum	m a sh r uu m
masuurdaal	m a s uu r d aa l
matxar	m a tx a r
meethiidaanaa	m ee th ii d aa n aa
meethiisaag	m ee th ii s aa g
meidaa	m ei d aa
miitxhaakadduu	m ii txh aa k a d d uu
miitxhaateel	m ii txh aa t ee l
mircaa	m i r c aa
mousambii	m ou s a m b ii
muulii	m uu l ii
muungphalii m uu n g ph a l ii
muungphaliikaateel	m uu n g ph a l ii k aa t ee l
naariyaljhaadxquu	n aa r i y a l jh aa dxq uu
neenuaa	n ee n u aa
niimbuu	n ii m b uu
niimbuu	l ii m b uu
paakudxq	p aa k u dxq
paalaksaag	p aa l a k s aa g
palaamuu	p a l aa m uu
papiitaa	p a p ii t aa
parawal	p a r w a l
pashcimiisingbhum	p a sh c i m ii s i n g bh u m
pashcimiisingbhum	p a sh c i m ii s i n g bh uu
phreencbiins	ph r ee n c b ii n s
phuulgobhii	ph uu l g o bh ii
phuulgobhii	ph uu l k o b ii
phuuljhaadxquu	ph uu l jh aa dxq uu
puudiinaa	p uu d ii n aa
puurwiisingbhum	p uu r w ii s i n g bh u m
puurwiisingbhum	p uu r w ii s i n g bh uu
pyaaz	p y aa z
pyaazsaag	p y aa z s aa g
raamgadxq	r aa m g a dxq
raamtil	r aa m t i l
raancii	r aa n c ii
rajniigandhaa	r a j n ii g a n dh aa
saaheebganj	s aa h ee b g a n j
sahajan	s a h j a n
sanaiiphuul	s a n a ii ph uu l
sapheedkadduu	s a ph ee d k a d d uu
saraaykeelaa	s a r aa y k ee l aa
saraaykeelaakharsaawaan	s a r aa y k ee l aa kh a r s aa w aa n
saraaykeelaakharsaawaan	s a r aa y k ee l aa kh a r s aa w aa
sarson	s a r s o n
sarsonkaateel	s a r s o n k aa t ee l
sarsonteel	s a r s o n t ee l
seeb	s ee b
seem	s ee m
shakarakand	sh a k a r k a n d
shalgam	sh a l g a m
shariiphaa	sh a r ii ph aa
shimalaamirc	sh i m l aa m i r c
siitaaphal	s ii t aa ph a l
simdxeegaa	s i m dx ee g aa
soyaabiin	s o y aa b ii n
suukhaamatxar	s uu kh aa m a tx a r
suurajmukhii	s uu r a j m u kh ii
suurajmukhiikeebiij	s uu r a j m u kh ii k ee b ii j
tarbuuj	t a r b uu j
teejpattaa	t ee j p a t t aa
til	t i l
tilkaateel	t i l k aa t ee l
toriyaa	t o r i y aa
turaii	t u r a ii
txamaatxar	tx a m aa tx a r
udxqaddaal	u dxq a d d aa l
<babble>	sil
<bn>	sil
<s>	sil
</s>	sil
sil	sil
!SIL	sil
